0001001001111
1100101110110
0101110001100
0000000000000
1110000001000
1110000000011
1111101111101
1100000001110
1111111110111
0101110001100
0000000000000
1110000001000
1111111110111
0101110001100