2200021000222
0000101110000
0201110001100
0200000000000
1110000001000
2210000000022
2211101001122
1100000001110
1111100110111
0101110001100
0000000000000
1110000001000
0000012010000
1100110000111