.............
.#.#.#.#.#.#.
.#.#.#.#.#.#.
.#.#.#@#.#.#.
.#.#.w.w.#.#.
.w.w.s.s.w.w.
s.ss.w.w.ss.s
t.ww.s.s.ww.t
.s.s.###.s.s.
.#.#.#.#.#.#.
.#.#.w.w.#.#.
.#.#.....#.#.
.............